9 5
#########
#S#.....#
#.#####.#
#......E#
#########
