11 6
###########
#S###.....#
#.###.###.#
#.....###.#
#####.#E#.#
###########
