12 10
############
#.#........#
#.#.######.#
#.#....#...#
#.###.E#.#.#
#...####.#.#
#.#.#..#.#.#
#.#.#.##.#.#
#S#......#.#
############
