15 7
###############
#S#...........#
#.#.#########.#
#.#.#.......#.#
#.#.#.#####.#.#
#...#.....E.#.#
###############
